asia-east1-a	Comté de Changhua, Taïwan, APAC	
asia-east1-b	Comté de Changhua, Taïwan, APAC	
asia-east1-c	Comté de Changhua, Taïwan, APAC	
asia-east2-a	Hong Kong, 
asia-east2-b	Hong Kong, 
asia-east2-c	Hong Kong, 
asia-northeast1-a	Tokyo, Japon, 
asia-northeast1-b	Tokyo, Japon
asia-northeast1-c	Tokyo, Japon
asia-northeast2-a	Osaka, Japon
asia-northeast2-b	Osaka, Japon
asia-northeast2-c	Osaka, Japon
asia-northeast3-a	Séoul, Corée du Sud
asia-northeast3-b	Séoul, Corée du Sud
asia-northeast3-c	Séoul, Corée du Sud
asia-south1-a	Mumbai, Inde
asia-south1-b	Mumbai, Inde
asia-south1-c	Mumbai, Inde

asia-southeast1-a
asia-southeast1-b	Jurong West, Singapour

asia-southeast1-c	Jurong West, Singapour
asia-southeast2-a	Jakarta, Indonésie
asia-southeast2-b	Jakarta, Indonésie
asia-southeast2-c	Jakarta, Indonésie
australia-southeast1-a	Sydney, Australie
australia-southeast1-b	Sydney, Australie
australia-southeast1-c	Sydney, Australie
europe-north1-a	Hamina, Finlande, Europe
europe-north1-b	Hamina, Finlande, Europe
europe-north1-c	Hamina, Finlande, Europe

europe-central2-a
europe-central2-b
europe-central2-c	Varsovie, Pologne, Europe

europe-west1-b	Saint-Ghislain, Belgique, Europe	
europe-west1-c	Saint-Ghislain, Belgique, Europe	
europe-west1-d	Saint-Ghislain, Belgique, Europe	
europe-west2-a	Londres, Angleterre, Europe
europe-west2-b	Londres, Angleterre, Europe	
europe-west2-c	Londres, Angleterre, Europe		
europe-west3-a	Francfort, Allemagne, Europe		
europe-west3-b	Francfort, Allemagne, Europe	
europe-west3-c	Francfort, Allemagne, Europe		
europe-west4-a	Eemshaven, Pays-Bas, Europe	
europe-west4-b	Eemshaven, Pays-Bas, Europe	
europe-west4-c	Eemshaven, Pays-Bas, Europe	

europe-west6-a
europe-west6-b
europe-west6-c	Zurich, Suisse, Europe		

northamerica-northeast1-a	Montréal, Québec, Amérique du Nord
northamerica-northeast1-b	Montréal, Québec, Amérique du Nord	
northamerica-northeast1-c	Montréal, Québec, Amérique du Nord	
southamerica-east1-a	Osasco, São Paulo, Brésil, Amérique du Sud		
southamerica-east1-b	Osasco, São Paulo, Brésil, Amérique du Sud	
southamerica-east1-c	Osasco, São Paulo, Brésil, Amérique du Sud
us-central1-a	Council Bluffs, Iowa, Amérique du Nord	
us-central1-b	Council Bluffs, Iowa, Amérique du Nord	
us-central1-c	Council Bluffs, Iowa, Amérique du Nord	
us-central1-f	Council Bluffs, Iowa, Amérique du Norde	GPU
us-east1-b	Moncks Corner, Caroline du Sud, Amérique du Nord	
us-east1-c	Moncks Corner, Caroline du Sud, Amérique du Nord	
us-east1-d	Moncks Corner, Caroline du Sud, Amérique du Nord	
us-east4-a	Ashburn, Virginie, Amérique du Nord	
us-east4-b	Ashburn, Virginie, Amérique du Nord	
us-east4-c	Ashburn, Virginie, Amérique du Nord	
us-west1-a	The Dalles, Oregon, Amérique du Nord	
us-west1-b	The Dalles, Oregon, Amérique du Nord	
us-west1-c	The Dalles, Oregon, Amérique du Norde	
us-west2-a	Los Angeles, Californie, Amérique du Nord		
us-west2-b	Los Angeles, Californie, Amérique du Nord	
us-west2-c	Los Angeles, Californie, Amérique du Nord	

us-west3-a
us-west3-b
us-west3-c	Salt Lake City, Utah, Amérique du Nord	

us-west4-a
us-west4-b
us-west4-c Las Vegas, Nevada, Amérique du Nord